NO ./images/north.xpm
SO ./images/south.xpm
WE ./images/west.xpm
EA ./images/east.xpm
F 220,100,0
C 225,30,0

                 1111
                 1001
                 1001
                 1001
        1111111111001111111111111
        1000000000000000000000001
       11000000000000000000000011111111
      100000000000000000000000000000001
     1000000000000000000000000111010101
      111111011111111011111111  1010101
           101      101         1010101
          1001      101          1 1 1  
         1001       101111111111111111
11111111110011111111100000000000000001
10000000000000000000000000011110011111
1111111111100000000000000001  1001
          100000000000000001   1001
          100000000000000001    1001
          111111111100011111     1001
                    101           1001
          111111111110111111       101
          100000000000000001       101
11111111111000000000000000011111   101
10000000000000000000000000000001   101
11111111111000000000000000011111   101
          100000000000000001       101
          100000000000000001111    101
          1000000000000000000001   101
          1N00000000000000011111111101
          111111111111111011  10000001
                        101   10111111
                        101111101
                        100000001
                        101111111
                         1