NO ./images/north.xpm
SO ./images/south.xpm
WE ./images/west.xpm
EA ./images/east.xpm
C 156,119,186
F 181,153,204

1111111111111111
1000000000000001
10000000000000001
1000000N000000001
1000000000000001
1111111111111111