NO ./images/north.xpm
SO ./images/south.xpm
WE ./images/west.xpm
EA ./images/east.xpm
C 156,119,186
F 181,153,204

                 1111
                 1001
                 1001
                 1001
        1111111111001111111111111
        1000000000000000000000001
       11000000000000000000000011111111111
      1000000000000000000000000000000000001
     100000000000000000000000011101010011001
      111111011111111011111111  1010101  1001
           101      101         1010101   101
          1001      101          1 1 1    101
         1001       101111111111111111    101
11111111110011111111100000000000000001    101
10000000000000000000000000011110011111  11101
1111111111100000000000000001  1001      10001
          100000000000000001   1001      101
          100000000000000001    1001     101
          111111111100011111     1001    101
                    101           1001111101
          111111111110111111       100000001
          100000000000000001       101111111
11111111111000000000000000011111   101
10000000000000000000000000000001   101
11111111111000000000000000011111   101
          100000000000000001       101
          100000000000000001111    101
          1000000000000000000001   101
          1N00000000000000011111111101
           11111111111111011  10000001
                        101   10111111
                        101111101
                        100000001
                        101111111
                         1